1 2 8 2 1
8 0 0 0 8
0 1 1 2 8
2 1 2 1 2
2 0 8 0 2